11111
1P001
100C1
10101
1E1C1
11111
