11111
1P0C1
10001
1E101
11111
