1111111111111111111
1000000001000000001
1011111101011111101
1010000001000000101
1010111111111110101
101C100000000010101
1011101111111010101
1000101000001010101
1110101011101010101
1E00100010001000C01
1011111010111111101
10100000100000C0101
1010111110111110101
1000100000100000001
1111101110101111111
100000000010000P001
1111111111111111111
