111111111111111111111
1P0000000000000000001
111111111111111111101
100000000000000000C01
101111111111111111111
10C000000000000000001
111111111111111111101
1000000000000000000C1
101111111111111111111
1000000000000000000C1
1000000000000000000C1
1000000000000000000C1
1000000000000000000C1
1000000000000000000C1
1000000000000000000C1
1000000000000000000C1
1000000000000000000C1
1000000000000000000C1
1000000000000000000C1
10C000000000000000E01
111111111111111111111
