1111111
1C001E1
101C101
1010101
1P100C1
1111111
